##################################################
##################################################
## #         # #   # #                     #   # #
## # ### ### # ### # ######### ############# ### #
##   # # #     #   # #               # # # # #   #
###### # # ### ### # ##### ##### ### # # # # # ###
## #     # #               #     #               #
## ############# ####### ### # ##### # ######### #
##             # #       #   #     # #         # #
#### ### ##### ### ##### # # ##### ########### # #
## # # # # #       #     # #   #             # # #
## ### ### ####### # # # ####### # # ##### ### ###
##       #         # # # #       # #   #     #   #
#### # # ##### ### ####### ### ##### ####### # ###
## # # #     # #     #       #   #   # #   # #   #
## ####### # ### # # ### # ### ### # # # ### #####
##     #   # #   # # # # # #   #   #       #     #
###### # ### ### # ### # # ### # # # # ##### # # #
##     # #   #   # #     # #   # # # #     # # # #
###### # ### ### ##### ### ##### # ### # # # ### #
## #     #           # #   #     # #   # # # # # #
## ##### # # # # ##### # # ### ### ### # ### # # #
## # #   # # # #   #   # #   # #     # #   # # # #
## # # ### ##### ### # # # ### # # ### # ##### ###
##     #   # # # # # # # # #   # #   # #         #
## ### ##### # ### # ### ######### ### # ### #####
## #     #             # #           # #   #     #
## ### ##### ##### # ##### ### ### # # # # ### ###
## #     #   #     #   # # #   # # # # # # #   # #
## ### ####### # # # ### ### # # ######### ### # #
##   #   #   # # # # #       #     #     #   #   #
#### # # ### # ##### ### ##### # # # ##### # # ###
##   # #   #   #   # #   #     # #       # # #   #
###### # ### ### # # # ### ### # ### ### ##### # #
## #   # #     # #   #   # #   #   #   #     # # #
## ### ##### # ### # # # ### ### ### # # #########
##         # # #   # # # #   #     # # #         #
## ### # # # # ### # # ### ##### # # ### # #######
## #   # # # # #   # #   #   #   # # #   #       #
#### ######### ### # # # ### # ### ##### # ##### #
##     # #   #   # # # # #   # #     #   #     # #
## # ### # ####### ### # ### ### # ##### # ##### #
## # #             #   # #     # #   #   #     # #
## # ### ##### ### # ### # # ### # ### # # ##### #
## # #     #     # # #   # #   # # # # # #   #   #
## ### ##### # # # # # # # ### ##### ##### ### # #
##     #     # # # # # # #   #         # #   # # #
## # # # # ### ##### # ### ##### ### ### ### # # #
## # # # #   #   #   #   #     #   #       # # # #
##################################################
